SSOOOOOOOOOSS
SXOXOXOXOXOXS
OOOOOOOOOOOOO
OXOXOXOXOXOXO
OOOOOOOOOOOOO
OXOXOXOXOXOXO
OOOOOOOOOOOOO
OXOXOXOXOXOXO
OOOOOOOOOOOOO
SXOXOXOXOXOXS
SSOOOOOOOOOSS