OO###OOO#O#SS
OX#XOXOXOXOXS
O#O###O##O##O
OX#XOXOX#X#X#
Z#OOOO#OOOOOO
#XOXOX#X#X#X#
#O#O###OOO###
OXOXOXOX#XOX#
OO####OO#OOOO
SXOXOX#XOXOXS
SS######O##SS
