000000000000
011111111110
022211112220
012112221110
022211221220
000000000000