000000000000000
011121212221110
010102020201010
012222222212210
020202020202020
022222222212220
010201020202010
022222221212220
020202020202020
012222222221210
010202020202010
011122121221110
000000000000000